0 0  2 0 _ U

2 0  3 1 D _
0 1  3 2 D _
0 2  3 3 D _

0 3  0 2 U _
3 2  0 1 U _
3 1  0 0 U _
3 0  0 0 R _


1 0  2 1 _ _
1 1  2 1 _ _
1 2  2 1 _ _
1 3  2 1 _ _

2 1  2 _ _ _


