0 0  3 3 L _
0 3  3 0 _ L
3 3  1 1 R _
0 1  0 2 D _
0 2  1 _ _ R
1 0  2 3 _ D
2 0  2 2 _ D
2 2  _ _ _ U
2 3  3 3 _ _

1 1  1 2 _ _
2 1  1 2 _ _
1 2  _ _ _ _