0 0  1 0 U R
0 1  _ 2 D _
1 2  _ _ _ R
1 0  _ 2 D _
0 2  2 1 _ _
2 1  _ _ _ _
