0 0  1 1 D _
0 1  0 2 D _

0 2  1 2 _ R
1 0  1 2 R _

1 1  2 2 _ L
2 2  _ _ _ L
2 0  3 _ _ D

3 0  3 3 R _
0 3  3 3 _ R

3 1  1 3 _ _
1 3  _ _ _ _